NO xpm/stone.xpm
SO     xpm/door.xpm
WE xpm/pipewall.xpm
EA  xpm/soil.xpm

F 255,0,255
C 0,255,0

11111111111111111111111111
10000000000000000000000001
10000000000010000000000001
11111100000000000001111111
     100000000E00001
     100111111111111
111111000000000000011111111
100000001111111100000000001
100000001      100000000001
111111111      111111111111