111111111111111111111
100000000000000000001
100000100000000000001
100000000000000000001
1010000N0000000001001
101000000000000001001
101000100000000001001
101000100000000001001
101000100000000001001
101000100000000001001
100000100000000000001
100000000000000000001
100000100000000000001
100000000000000000001
100000100000000000001
100000000000000000001
100000100000000000001
100000000000000000001
100000100000000000001
100000000000000000001
111111111111111111111