111111111111111
100000000000001
100000100000001
100000000000001
1010E0000001001
101000000001001
101000100001001
111111111111111