NO xpm/stone.xpm
SO     xpm/door.xpm
WE xpm/pipewall.xpm
EA  xpm/soil.xpm

F 255,0,255
C 0,255,0


111111111111111111111111
111101000100010000000001
  1000000000010000000001
111000100001000000000001
100000000100000000000001
1111000000010101000011001
  10100000000101000010111
111000100100000000000001
101000101001000000000101
1010001000000N0000001001
100000100000000000000001
1000001000000000000000011111111
111111111111110000000000000000111111
			100000000000000000000001
111111111111100000000001111111111111
100000100000000000000001
100000100000000000000111
100000000000000000000001
100000100000000000000001
100000100000000000000001
100000100000000000000001
100000100000000000000001
100000100000000000000001
100000100000000000000001
100000100000000000000001
100000100000000000000001
100000100000000000000001
100000100000000000000001
100000100000000000000001
100000100000000000000001
100000100000000000000001
100000000000000000000001
100000100000000000000001
100000100000000000000001
100000100000000000000001
100000100000000000000001
100000100000000000000001
100000100000000000000001
100000100000000000000001
100000100000000000000001
100000100000000000000001
100000000000000000000001
100000100000000000000001
100000100000000000000001
100000100000000000000001
100000100000000000000001
100000100000000000000001
100000100000000000000001
100000100000000000000001
111111111111111111111111