NO xpm/stone.xpm
SO     xpm/door.xpm
WE xpm/pipewall.xpm
EA  xpm/soil.xpm

F 255,0,255
C 0,255,0


111111111111111111111111111111111111111      11111111111111111111111111111111111111111111111111111
100000000000000000000000000000000000001      10000000000000000000000000000000000000000000000000001
100000000000000000000000000000000000001      10000000000000000000000000000000000000000000000000001
100000010010010000000000000000000000001      11111111111000000000000000000111111100000000000000001
100000000000000000000000000000000000001      111111111110000000000000000001     100000000000000001
100000010010010000000000000000000000001      100000000000000000000000000001     100000000000000001
100000000000000000000000000000000000001111111100000000000000111111111111111     100000000000000001
1000000100100100000000010000000000000000000000000000000000001                   100000000000000001
1000000000000000000000010000000000000000000000000000000000001111   11111111     100000000000000001
1000000000000000000000010000000000000000000000000000000000000001   10000001     100000000000000001
1000000000000000000111111111000000000000000000000000000E00000001   10000001     100000000000000001
100000000000000000000001000000000000000000000000000000000000000111110000001     100000000000000001
100000000000000000000001000000000000000000000000100000000000000000000000001     100000000000000001
100000000000000000000001000000000000000000000000111111111111111111111111111     111111111111111111
1000000000000000000000000000000000000000000000001
1000000101000000000000000000000000000000000000001
1000000101000000000000000001111100000000000000001
1000000101000000000000000001   100000000111111111
1000000101111110000000000001   100000000111111111
1000000100000000000000000001   100000000000000001
1000000111111110000000000001   100000000000000001
1000000000000000000000000001   100000000000000001
1111111111111111111111111111   111111111111111111