con

dsafdsa
fsad
fcntlsad
fcntlads
fsadf
dsafdsa
sad
fsadf
asd
fcntlsadfasd
fcntlsadfsad
fcntl
asdf
sad
fcntlsadfasdsda
fcntlsad



negratio


asdf
dsafdsaas
dataf
dsafdsasad





111111111111111111111111
111101000100010000000001
111000000000010000000001
111000100001000000000001
100000000100000000000001
11110000E001010100001101
110100000000101000010111
111000100100000000000001
101000101001000000000101
101000100000000000001001
100000100000000000000001
100000100000000000000001
111111111111110000000001
111111111111000000000001
100000100000000001111111
100000100000000000000001
111111110000010000000001
1111100000000000000000011111111
1111111100000100000000000000001
1111001000000000000000011111111
111111111111110000010001
111110010000000000000001
100000100000000000000001
100000100000000000000001
10000010000000000000000111111111
11111111100000100000000000000001
10000010000000000000000111111111
100000100000000000000001
100000100000000000000001
100000100000000000000001
100000100000000000000001
100000000000000000000001
100000100000000000000001
100000100000000000000001
100000100000000000000001
100000100000000000000001
100000100000000000000001
100000100000000000000001
100000100000000000000001
100000100000000000000001
100000100000000000000001
100000000000000000000001
100000100000000000000001
100000100000000000000001
100000100000000000000001
100000100000000000000001
100000100000000000000001
100000100000000000000001
100000100000000000000001
111111111111111111111111