111111111111111111111
100000000001000000001
100000100001000000001
100000000100000000001
1010000S0010101011001
101000000001010101101
101000100100000000001
101000101001000000101
101000100010000001011
101000100000000001001
100000100000000000001
100000000000000000001
100000100000000000001
100000000000000000001
100000100000000000001
100000000000000000001
100000100000000000001
100000000000000000001
100000100000000000001
100000000000000000001
111111111111111111111