SO     xpm/door.xpm
WE xpm/pipewall.xpm
EA  xpm/soil.xpm

F 255,0,255

C 0,255,10
NO xpm/stone.xpm

11111111111111111111111111
10000000000000000000000001
10000000000000000000000001
11111111100000001111111111
        1000N0001
        100000001
        100000001
        100000001
        100000001
        111101111
11111111111101111111111111
10000000000000000000000001
10000000000000000000000001
11111111100000001111111111
        100000001
        100000001
        100000001
        100000001
        100010001
        111111111
