SO     xpm/door.xpm
WE xpm/pipewall.xpm
EA  xpm/soil.xpm

F 255,0,255

C 0,255,10
NO xpm/stone.xpm


        1111111111111111111111111
        0000000000110000000000001
        0011000001110000000000001
        0001000000000000000000001
111111111011000001110000000000001
100000000011000001110111111111111
11110111111111011100000010001
11110111111111011101010000001
11000000110101011100000000001
10000000000000001100000010001
10000000000000001101010010001
110000011101010111110111100111
11110111 1110101 101111010001
11111111 1111111 111111111111